Vladan_Đorđević	party	Fianna_Fáil
Boele_Staal	country	Germany
Fadil_Hoxha	successor	Don_Getty
M._D._H._Jayawardena	successor	Stéphane_Le_Foll
Tang_Siu-tong	party	Liberal_Party_of_Australia
Antonio_Bassolino	successor	Vladimir_Voronin
Smith_Thompson	party	Austrian_People's_Party
W._M._Salisbury	successor	Juan_de_Arraçola
Natalia_Korolevska	party	Communist_Party_of_China
Bill_Sarto	religion	Jews
Olusegun_Oni	successor	James_Bowman_(Canadian_politician)
Drew_Perkins	party	Law_and_Justice
Walter_Ulbricht	party	New_Century_Forum
Patti_McLeod	party	Fianna_Fáil
Irène_de_Lipkowski__France-politician-stub__1	country	United_Kingdom
Adalberto_Madero	successor	Alexander_Moncur
Alliance_for_the_Republic_(Senegal)	country	Serbia
Lionel_Chevrier	predecessor	Jay_Warren
Lou_Heard	successor	Randolph_McKinnon
Joseph_Dodds	country	China
Ömer_Çelik	party	Australian_Labor_Party
R._Harry_Bittle	party	Labour_Party_(UK)
Leslie_Munro	successor	Talmadge_Baker
Ignacio_De_La_Fuente	successor	Colin_Gabelmann
Hamdeen_Sabahi	religion	Judaism
Marcus_Aemilius_Lepidus_(consul_187_BC)	successor	Kenneth_Daniel
Fred_Peacock	party	Civic_Platform
Craig_Leonard	successor	Dan_Crummell
Ramón_Martínez_(Governor)	party	Communist_Party_of_China
Alija_Behmen	successor	Hassan_Pirnia
Jean-Michel_Ferrand	successor	Ralph_Knox
Karn_Manhas	party	Progressive_Conservative_Party_of_Ontario
Alfred_Dohring__Australia-Labor-politician-stub__1	party	Conservative_Party_(UK)
Lahcen_Haddad	party	Jacksonian_democracy
Sahana_Pradhan	party	Social_Democratic_Party_of_Germany
Pat_Morton	party	Indian_National_Congress
Dolph_Eddy	party	Labour_Party_(UK)
George_E._Nowotny	party	Fianna_Fáil
Marcus_Aemilius_Lepidus_(consul_187_BC)	successor	Edward_Mulcahy_(Australian_politician)
Frank_Ash_Yeo	party	New_Democratic_Party
Ramasamy_Palanisamy	party	Conservative_Party_(UK)
Zwelakhe_Sisulu	party	Labour_Party_(UK)
Mladen_Lorković	otherParty	Pakistan_Muslim_League_(N)
Julian_Mack	party	Communist_Party_of_China
Tom_Bakk	party	Austrian_People's_Party
John_Dawkins	successor	Moss_Cass
Tin_Pei_Ling	party	Progressive_Conservative_Party_of_Ontario
Luis_Bedoya_Reyes	successor	Gerald_Grosz
Mary_Anne_Jablonski	successor	Graham_Sucha
Ken_Cooley	party	Social_Democratic_Party_of_Germany
Silviu_Prigoană	party	Law_and_Justice
Teodor_Pejačević	party	Democratic-Republican_Party
Stefania_Prestigiacomo	predecessor	Richard_Crossman
Arthur_Massé	party	Social_Democratic_Party_of_Austria
Robin_Jorgenson	successor	Jean-Baptiste_Blanchet
Daniel_Campbell_(Canadian_politician)	successor	Tim_Watts_(politician)
Bahder_Djohan	successor	John_Erickson_(Oregon_politician)
Pedro_Aleixo	successor	Edgardo_Angara
Jeff_Nesset	party	Social_Democratic_Party_of_Germany
Julián_Montellano	successor	Dan_Crummell
Kevin_Cotter	party	Indian_National_Congress
Francesco_Cossiga	party	Madagascar_for_the_Malagasy
Jack_D._Steinhilber	country	Netherlands
Yuen_Long_District_Council	politicalPartyOfLeader	Democratic_Party_(United_States)
Tshering_Tobgay	party	Liberal_Party_(UK)
Janine_Freeman__Australia-Labor-politician-stub__1	party	Indian_National_Congress
Kenneth_Mitchell_(politician)	religion	Shia_Islam
John_Kucherepa	successor	Andrés_Mellado_Fernández
United_States_Senate	politicalPartyOfLeader	Liberal_Party_of_Newfoundland_and_Labrador
Els_Schelfhout	party	Law_and_Justice
Brittany_Pettersen	party	Law_and_Justice
Volker_Bouffier	deputy	Jean_Nkuete
William_M._Lanning	successor	Gerry_Gibeault
John_J._Mahoney	party	Conservative_Party_(UK)
Amrik_Virk	party	Republican_Party_(United_States)
Jürgen_Hardt	party	Austrian_People's_Party
Oscar_Luigi_Scalfaro	party	Party_for_Civic_and_Patriotic_Action
Ángel_Rosa	party	Fianna_Fáil
Larry_Shaben	successor	Rex_Patterson
Warren_Magnuson	successor	Gladys_Porter
George_Hahn_(politician)	party	Labour_Party_(UK)
Deodoro_da_Fonseca	country	Kuwait
Thomas_Brady_(mayor)	party	Indian_National_Congress
Noemí_Rial	party	Communist_Party_of_China
Mario_Ramón_Beteta	party	Conservative_Party_(UK)
William_J._Phelan	party	Conservative_Party_(UK)
Mike_Parson	party	Indian_National_Congress
Bryan_Kaenrath	party	Social_Democratic_Party_of_Austria
Nidia_Vílchez	successor	Joseph_Warner_Murphy
Thomas_Barnard_Flint	party	Social_Democratic_Party_of_Germany
Movement_for_Greater_Israel	country	United_States
Oliver_Badman	successor	Steven_Myers_(politician)
Gaston_J._Sigur,_Jr.	predecessor	Robert_Drinan
Wellington_R._Burt	party	Social_Democratic_Party_of_Germany
Alex_Munter	successor	Graeme_Bowbrick
Etienne_Schneider	party	Communist_Party_of_China
Gibson_E._Armstrong	party	Law_and_Justice
Burford_Sampson	party	Indian_National_Congress
Gábor_Fodor_(politician)	party	Communist_Party_of_China
Bud_Asher	successor	José_Marina_Vega
Gan_Thiam_Poh	party	Social_Democratic_Party_of_Austria
Randy_Revelle	party	Australian_Labor_Party
Larry_Shaben	successor	Asa_Woodward
Clarrie_Robertson	religion	Christian
John_Preston_Buchanan	party	Law_and_Justice
Francisco_José_Jattin_Safar	religion	Hinduism
Maureen_Reed	party	Democratic_Party_(United_States)
György_Szabad	party	Democratic-Republican_Party
Joanne_Giannini	party	Fianna_Fáil
Olusegun_Osoba	predecessor	Ray_Bailey
Doug_Turner	religion	Hinduism
Thanmanpillai_Kanagasabai	religion	Baptists
Valeriy_Borzov	party	United_Popular_Front_(Iraq)
M._Krishnasamy	party	Conservative_Party_(UK)
Edward_Gibbon	successor	Francisco_Morazán
Ron_Galperin	party	Progressive_Conservative_Party_of_Ontario
Hira_Singh_Gabria	party	Liberal_Party_(UK)
Mark_Danish	party	Communist_Party_of_China
Joe_Debono_Grech	party	Indian_National_Congress
Juan_Carlos_Escamilla	party	Indian_National_Congress
Christian_Democratic_Union_(East_Germany)	nationalAffiliation	History_of_the_United_States_Democratic_Party
Jim_Reese	successor	Preston_Doerflinger
C.T._Wilson	party	Civic_Platform
Leroy_Welsh	party	Social_Democratic_Party_of_Germany
Milton_DeLano	successor	Joseph_de_Olivera
William_Earl_Reid	party	Social_Democratic_Party_of_Germany
Venetian_Independence	splitFromParty	Meeting_Point
John_Gardner_(Rhode_Island)	predecessor	Thomas_McIlwraith
Leland_Payson_Bancroft	successor	Gary_Vey
Joseph_Akahan	predecessor	Robert_Walpole
William_B._Reed_(politician)	religion	Episcopal_Church_(United_States)
Felix_Perera	party	Indian_National_Congress
Jorge_Noguera_Cotes	otherParty	Sinn_Féin
Ed_Homan	party	Liberal_Party_(UK)
Elizabeth_Halseth	party	Austrian_People's_Party
Tom_Stevens_(politician)	party	New_Democratic_Party
Lin_Gordon	party	Communist_Party_of_China
Frederick_Tout	religion	Christian
Tom_Gilmore,_Sr.	religion	Presbyterianism
Alexander_S._Johnson	party	Indian_National_Congress
Ernesto_Maceda	successor	Daniel_Gordon_(politician)
Floyd_B._Olson	party	Republican_Party_(United_States)
Morihiro_Hosokawa	otherParty	Fianna_Fáil
Russell_MacLellan	predecessor	John_Easton
Geneva_Citizens'_Movement	country	Turkey
Guasú_Front	internationalAffiliation	European_Liberal_Youth
Francis_C._Speight	party	Democratic-Republican_Party
William_Kenrick_(Birmingham_MP)	country	India
Glen_Sheil__Glen_Sheil__1	party	Social_Democratic_Party_of_Germany
J._Thiviyanathan	party	Austrian_People's_Party
Progressive_Conservative_Association_of_Alberta	successor	Progressive_Conservative_Party_of_Ontario
Léo_Cadieux	predecessor	Adetokunbo_Kayode
Gary_Sherman_(politician)__Wisconsin-politician-stub__1	country	Australia
Dimitri_Soudas	predecessor	Joseph_Lamothe
Hilbrand_Nawijn	party	Action_Congress_of_Nigeria
Christian_Democratic_Union_(East_Germany)	nationalAffiliation	United_Regions_of_Serbia
Zoltán_Rónai	party	Social_Democratic_Party_of_Austria
Beli_Ram_Das	party	Austrian_People's_Party
Leland_Barrows	country	China
Don_Chipp	successor	Luis_Alfredo_Ramos
Rodney_Cavalier	successor	Jack_Marshall
Michaela_Boyle	party	Fianna_Fáil
Thomas_Greenhill	successor	Isaac_Penington_(Lord_Mayor)
Fadil_Hoxha	successor	George_Harry_Webster
Željko_Turk	party	Conservative_Party_(UK)
Thomas_Gifford_(politician)	predecessor	J.-Eugène_Lefrançois
South_Yorkshire_Young_Labour	colour	Violet_(color)
D._S._Senanayake	successor	Rickard_Sandler
Jatuporn_Prompan	party	Danish_People's_Party
Jean_Leonetti	party	Conservative_Party_(UK)
Luis_Alva_Castro	successor	Ann-Marit_Sæbønes
Johnny_Ray_Turner	party	Liberal_Party_(UK)
Frédéric_Houde	predecessor	Gordon_E._Snow
Fatma_Şahin	successor	Joseph_de_Olivera
Arthur_Annesley,_5th_Earl_of_Anglesey	party	Pakistan_Muslim_League_(N)
András_Rapcsák	party	Conservative_Party_(UK)
Ken_McCaw	party	Conservative_Party_(UK)
Nik_Abdul_Aziz_Nik_Mat	successor	Leena_Meri
James_Boyd_(Australian_politician)	successor	Ronald_D._Williams
Earl_Williams_(politician)	successor	Ivo_Andrić-Lužanski
Reginald_Cooray	successor	Salahuddin_Rabbani
John_Crosbie	successor	John_Winthrop
Council_of_Representatives_of_Iraq	politicalPartyInLegislature	National_Party_(Pakistan)
Tan_Cheng_Bock	successor	Kunwar_Sarvesh_Kumar
Andy_Gardiner	party	Law_and_Justice
Michael_Leighton_(politician)__Australia-Labor-politician-stub__1	party	Conservative_Party_(UK)
Henry_Gridley	party	Minnesota_Democratic–Farmer–Labor_Party
Hasan_Celal_Güzel	party	Democratic-Republican_Party
Freedom_Party_of_Austria	internationalAffiliation	International_Communist_Seminar
Art_Cowie	party	Conservative_Party_(UK)
Alexandru_Sibirski	religion	Baptists
Adolph_R._Bucknam	country	Norway
Sydney_Lavers	party	Conservative_Party_(UK)
Dessie_Larkin	otherParty	Law_and_Justice
Roel_van_Duijn	party	Bharatiya_Lok_Dal
Stephen_Henry_Phillips	successor	Hugh_Scott
Fernand_Leblanc	party	Progressive_Conservative_Party_of_Ontario
William_Wilberforce	successor	C._A._S._Marikkar
New_Political_Center_-_Girchi	mergedIntoParty	Social_Democrat_Radical_Party
Rosemary_Brown_(politician)	predecessor	Merv_Everett
Aung_Thaung	party	Communist_Party_of_China
Byron_J._Matthews	party	Pakistan_Muslim_League_(N)
John_Clarke_Moore	party	Communist_Party_of_China
Lista_za_Rijeku_-_Lista_per_Fiume	country	United_Kingdom
Joseph_E._Warner	predecessor	Jules_Maaten
Paul_McMurtry	party	Law_and_Justice
Kenneth_R._Plum	party	Indian_National_Congress
David_T._Caldwell	party	Indian_National_Congress
Austen_Chamberlain	successor	Philip_Snowden,_1st_Viscount_Snowden
Marguerite_Quinn	party	Australian_Labor_Party
Raúl_Armando_Barrionuevo	party	Fianna_Fáil
Wang_Shengjun	predecessor	Ambrogio_Spinola,_1st_Marquis_of_the_Balbases
David_Hamer	successor	Andrés_Mellado_Fernández
Abadula_Gemeda	party	Austrian_People's_Party
Frank_D._Allen	party	Civic_Platform
Mayantha_Dissanayake	party	New_Zealand_Labour_Party
Paul_W._Brown	party	Communist_Party_of_China
The_Alliance_(France)	europeanParliamentGroup	European_Democratic_Union
Donald_Ellsworth_Walter	party	Communist_Party_of_China
Kim_Hendren	party	Indian_National_Congress
Jonathan_Earle_Arnold	country	Germany
James_Sloan_Kuykendall	party	Conservative_Party_(UK)
Ömer_Dinçer	religion	Wisconsin
Steve_Young_(politician)	successor	Harris_Turner
Jean-Marie_Sermier	party	Communist_Party_of_China
Franck_Marlin	party	Austrian_People's_Party
Nik_Abdul_Aziz_Nik_Mat	successor	Len_Goucher
Charles_G._Hawkins	party	Social_Democratic_Party_of_Austria
Edward_Holton	party	Social_Democratic_Party_of_Austria
Bo_Callaway	successor	Benjamin_Franklin_Perry
Jason_Brodeur	party	Communist_Party_of_China
Nuno_Melo	party	Liberal_Party_of_Canada
John_Ceretto	otherParty	Fine_Gael
Juan_Bravo_Murillo	predecessor	Otto_Baird_Price
Social_Protection_People's_Party	mergedIntoParty	Liberal_Union_(Italy)
Tommy_Sowers	party	Fianna_Fáil
Manmeet_Bhullar	religion	Catholicism
Amy_Khor	successor	Clive_Lewis_(politician)
John_Holdren	party	Indian_National_Congress
William_McCall_(Australian_politician)	successor	Gerald_Strickland,_1st_Baron_Strickland
Núria_de_Gispert_i_Català	predecessor	Carolina_Barco
Manzushir_Khutagt_Sambadondogiin_Tserendorj	successor	Luke_Clippinger
Nikola_Mushanov	successor	Gyula_Szapáry
Amir_H._Jamal	party	Civic_Platform
Henry_Greenslade	predecessor	William_Paterson_(judge)
A._Jayamohan	party	Jacksonian_democracy
Khas-Ochiryn_Luvsandorj	successor	Fernando_Ortiz_Arana
Alvin_Benjamin_Rubin	party	Australian_Labor_Party
Chan_Kong_Choy	successor	Peter_Fragiskatos
Harald_Haas_(Pirate_Party)	knownFor	Girondins
Steve_Kerrigan	party	Communist_Party_of_China
Cordell_Hull	successor	Greg_Warren_(politician)
Croatian_Labourists_–_Labour_Party	country	Australia
Erda_Walsh	party	Fine_Gael
Branko_Grčić	party	Social_Democratic_Party_of_Austria
William_J._Street	successor	Joseph_de_Olivera
Maamoon_Sami_Rasheed_al-Alwani	successor	Fernando_Ortiz_Arana
Nicolaus_Ferdinand_Haller__Germany-politician-stub__1	country	India
Badi-ud-din_Mahmud	successor	Mattias_Karlsson_(politician)
Eugène_Claudius-Petit	party	Liberal_Party_(UK)
Thomas_Hooker_(Michigan_politician)	party	Democratic_Party_(United_States)
Valeriu_Nemerenco	religion	Catholicism
Bill_Veitch	successor	Juhar_Mahiruddin
Somchai_Wongsawat	party	Liberal_Party_of_Australia
Brian_Langley	party	Indian_National_Congress
Steve_Cappiello	party	Jacksonian_democracy
Radu_Vasile	otherParty	Social_Democratic_Workers'_Party_(Netherlands)
Lonnie_Randolph_(Indiana_politician)	party	Liberal_Party_(UK)
Alex_Munter	successor	Thomas_Rasey
Nikolai_Gubenko	party	Fine_Gael
Robert_H._Johnson	party	Social_Democratic_Party_of_Germany
Attilio_Terragni	party	Austrian_People's_Party
Elliot_D._Coleman	party	Fianna_Fáil
Thomas_Gavan_Duffy	country	Italy
Egyptian_Communist_Party	country	Australia
William_Henry_Golding	party	Labour_Party_(UK)
Memucan_Hunt,_Jr.	successor	David_Ouellet_(politician)
Alfred_Edmond_Bourgeois	party	Law_and_Justice
National_Trust_Party_(Iran)	nationalAffiliation	Conservatism
Garrett_Richter	party	Indian_National_Congress
Mahmut_Özdemir	party	Jacksonian_democracy
Marie_Tansey	party	Social_Democratic_Party_of_Germany
Anton_Klaus	country	India
Sir_Richard_Browne,_1st_Baronet,_of_London	successor	Thomas_Hubert_Stinson
Nidia_Vílchez	successor	Piotr_Mohyła
Davut_Kavranoğlu	religion	Hindu
Ottaviano_Del_Turco	party	Brazilian_Democratic_Movement
Manuel_Bonilla	successor	Yagub_Mammadov_(politician)
Edgar_Dawes	successor	Benjamin_Isaacs
Eli_Nesdoly	successor	Tissa_Attanayake
John_Ubah	successor	José_Gregorio_Salazar
Graham_Jacobs	party	Indian_National_Congress
Shettima_Mustapha	predecessor	J.-Eugène_Lefrançois
Dáil_Éireann_(Irish_Republic)	leader	Nana_Konadu_Agyeman_Rawlings
Kerry_Towle	party	Australian_Labor_Party
Dwight_Dudley	party	Conservative_Party_(UK)
William_Ewart_Gladstone	party	Liberal_Popular_Alliance_–_Autonomies
Siv_Friðleifsdóttir	party	Conservative_Party_(UK)
Tancredo_Neves	successor	Angidi_Chettiar
Zhang_Guohua	successor	Federico_Acuña_(politician)
Thomas_B._Butler	successor	Henry_McBride_(politician)
Sarah_Henderson	party	Conservative_Party_(UK)
George_Clive_(Liberal_politician)	party	Law_and_Justice
Christopher_Chung	predecessor	Ron_Dellums
Horace_H._Smith	country	Norway
Arthur_Clarey	party	Liberal_Party_of_Australia
Nathaniel_Wales	party	Labour_Party_(UK)
Abel_Nathaniel_Bankole_Stronge	party	Pakistan_Muslim_League_(N)
Reginald_Reynolds_Amponsah	otherParty	Fine_Gael
David_Huebner	successor	Isaac_Penington_(Lord_Mayor)
Sean_O._Cota	party	Social_Democratic_Party_of_Austria
Mary_Wendy_Roberts	successor	Jules-Joseph-Taschereau_Frémont
Betty_Kiernan__Australia-Labor-politician-stub__1	party	Liberal_Party_(UK)
Heinrich_Oster	party	Social_Democratic_Party_of_Austria
Neera_Tanden	party	Austrian_People's_Party
Marcel_Deneux	country	Australia
Bennion_Spencer	party	Conservative_Party_(UK)
Eudaldo_Báez_Galib	party	Democratic_Party_(United_States)
Ivan_Wettengel	country	Bulgaria
Juan_de_la_Cierva_y_Peñafiel	successor	Terry_Shannon_(politician)
Sally_Bolster	party	Law_and_Justice
Parvin_Ahmadinejad	party	Conservative_Party_(UK)
Robert_T._Oestreicher	party	Democratic-Republican_Party
Chris_Benge	successor	Bekir_Bozdağ
Nasharudin_Mat_Isa	religion	Episcopal_Church_(United_States)
Frederik_Bos	country	United_States
Anthony_Mandile	successor	Juan_de_Arraçola
Jessica_Orsini	successor	Richard_Vryling_Lesueur
Ira_Roe_Foster	country	China
Eduardo_Paes	religion	Episcopal_Church_(United_States)
Marcus_Aemilius_Lepidus_(consul_187_BC)	successor	Ray_Greenwood
George_Smathers	successor	Raymond_F._Lederer
Edward_Beauchamp	country	India
William_Morrison_(Alberta_politician)	country	Germany
Stiles_Curtis	successor	Donald_Sinclair_(diplomat)
Marcus_Mojigoh	party	Austrian_People's_Party
Christian_A._Herter,_Jr.	party	Conservative_Party_(UK)
Eve_Adams	successor	Lois_Boone
Charles_R._Ladd	party	Social_Democratic_Party_of_Germany
Mbhazima_Shilowa	successor	Rochester_and_Strood_by-election,_2014
Jack_Donahue_(politician)	party	Democratic_Party_(United_States)
Malik_Abrar_Ahmad	party	Communist_Party_of_China
Doreen_Lawrence	soundRecording	Robert_Winston__2
Phil_GiaQuinta	party	Indian_National_Congress
Charles_P._Cary	country	Bulgaria
Angela_Owen-Taylor	party	Fianna_Fáil
Edward_Kenny	predecessor	Al_Lang
Sudanese_Ba'ath_Party	splitFromParty	National_Unity_of_Hope
Kevin_Dwyer_(politician)	party	Social_Democratic_Party_of_Austria
Jack_Keir	successor	Ferdinand_Kuehn
Mark_M._Noble	party	Conservative_Party_(UK)
Fuad_Issa_al-Jouni	party	Indian_National_Congress
Peter_M._Neal	party	Indian_National_Congress
Heather_Fitzenhagen	party	Liberal_Party_(UK)
Robert_Halfon	party	Liberal_Party_of_Canada
Ray_Meiklejohn	party	Australian_Labor_Party
Marcus_Aemilius_Lepidus_(consul_187_BC)	successor	Dahiru_Mohammed
Benedek_Jávor	party	Australian_Labor_Party
Bruno_Le_Maire	party	Social_Democratic_Party_of_Germany
Craig_Huey	party	Sinn_Féin
Manolis_Sfakianakis	religion	Catholicism
Arthur_Hodgson	predecessor	Mouldi_Kefi
Jean-Yves_Bony	party	Indian_National_Congress
Carol_Springer	party	Democratic_Party_(United_States)
Clemente_Agosto	party	Indian_National_Congress
Irwandi_Yusuf	successor	Max_Campbell
New_Progressive_Party_(South_Korea)	country	Croatia
Ziad_Bahaa-Eldin	predecessor	Robert_William_Keate
Alfred_Cerullo	successor	Stephen_Fiala
Thomas_Cantley	successor	Percy_Vermer_Noble
Alphonse_Gourd	country	United_States
Jim_Hillyer_(politician)	party	Liberal_Democrats
Hilda_Watson	successor	Heber_Smith
Lia_Finocchiaro	party	Law_and_Justice
Thanom_Kittikachorn	religion	Sunni_Islam
Fadil_Hoxha	successor	G._Sanjeeva_Reddy
Union_of_Chinese_Nationalists	colour	White
Marc_Robinson_(politician)	party	Law_and_Justice
Renato_Brunetta	otherParty	Sinn_Féin
James_Cleverly	successor	Ian_Mearns
Carlo_Giovanardi	party	People's_Party_of_Abkhazia
Historical_Left	mergedIntoParty	New_Hampshire_Republican_State_Committee
Freddie_Rodriguez	party	Liberal_Party_of_Canada
Templin_Potts	successor	Ralph_Knox
Bakht_Baidar	party	Social_Democratic_Party_of_Austria
Joseph_Dumont	party	Social_Democratic_Party_of_Austria
Shi_Yunsheng	party	Fine_Gael
Sun_Shiyi	country	Israel
Hector_McIvor	successor	Henry_Nicholas_Paint
National_Assembly_of_Sudan	politicalPartyInLegislature	Communist_Party_of_the_Russian_Federation
Ian_Sinclair	predecessor	Camilo_Osías
Dave_Kleis	party	Liberal_Party_of_Canada
Antonio_Hernández_Mancha	party	Conservative_Party_(UK)
Cynthia_Ortega	religion	Presbyterianism
Rose_Bogardus	party	Communist_Party_of_China
Leslie_Munro	successor	Ahmed_Hussain_Macan_Markar
Nidia_Vílchez	successor	Pulavar_K._Govindan
Tom_Daxon	party	Social_Democratic_Party_of_Austria
Deodoro_da_Fonseca	country	Free_City_of_Danzig
Mike_Brubaker	party	Indian_National_Congress
Josef_Frenken	country	United_States
Pratik_Prakashbapu_Patil__INC-politician-stub__1	party	Labour_Party_(UK)
Gippy_Graham	party	Australian_Labor_Party
Andrei_Găină	religion	Presbyterianism
Mac_Abbott	party	Liberal_Party_of_Canada
James_E._Berry	party	Conservative_Party_(UK)
Rafat_Bayat	religion	Hinduism
Khadra_Haji_Ismail_Geid	party	Conservative_Party_of_Canada
Massoud_Khalili	successor	Thomas_Arkell
Bert_Stevenson	party	Communist_Party_of_China
Bahtiyar_Aydın	country	Netherlands
Thomas_Locke	party	Republican_Party_(United_States)
Darcie_Lanthier	party	Social_Democratic_Party_of_Germany
Lichfield_District_Council	politicalPartyOfLeader	Liberal_Party_of_Newfoundland_and_Labrador
José_Jiménez_Negrón	party	Pakistan_Muslim_League_(N)
Stephen_Day_(British_politician)	successor	Christopher_Warner
Kembi_Gitura	party	Communist_Party_of_China
Arvid_Horn	successor	Craig_Coolahan
Juan_de_la_Cierva_y_Peñafiel	successor	Björgvin_G._Sigurðsson
John_Manners-Sutton,_3rd_Viscount_Canterbury	predecessor	Alireza_Ali-Ahmadi
Gian_Carlo_di_Martino	successor	Pablo_Pérez_Álvarez
Yvon_Godin	successor	Zairil_Khir_Johari
Andy_Gardiner	party	Sinn_Féin
Thom_Goolsby	party	Australian_Labor_Party
Charles_J._Noyes	successor	Charles_J._Noyes
Sir_Charles_Sykes,_1st_Baronet	party	Liberal_Party_of_Canada
Ros_Jones	party	Liberal_Party_of_Canada
Harrie_Mitchell	party	Communist_Party_of_China
Mohd_Nor_Othman	successor	Rosemary_Spencer
Ronald_Weiser	party	Fianna_Fáil
Mary_L._Washington	party	Conservative_Party_(UK)
Boris_Bershteyn	party	Communist_Party_of_China
Moinuddin_Haider	party	Australian_Labor_Party
Renee_Ellmers	party	Austrian_People's_Party
Revolutionary_Action_Party	nationalAffiliation	Conservatism
Moroccan_general_election,_2007	secondLeader	Conrad_Maduro
Ed_Struiksma	party	Liberal_Party_of_Canada
Nikita_Salogor	party	Austrian_People's_Party
Peter_Browne_(Australian_politician)	successor	Lois_Boone
Gustavo_de_Greiff	party	Law_and_Justice
Ottaviano_Del_Turco	party	Christian_Social_Union_in_Bavaria
John_Sullivan_(general)	successor	Godlove_Stein_Orth
Laila_Dåvøy	successor	John_Carruthers_(politician)
Scott_Andrews_(politician)	successor	Incumbent
Csaba_Molnár	otherParty	Social_Democratic_Party_of_Austria
Sally_Shelton-Colby	country	Italy
Vaughn_Soffe	successor	Chiang_Peng-chien
Toi_Hutchinson	predecessor	James_B._Brennan
Mercedes_Cabanillas	successor	Michael_J._Dowling_(Minnesota_politician)
Henry_Paget,_4th_Marquess_of_Anglesey	party	Fianna_Fáil
John_MacDonald_(Australian_politician)	successor	Gonzalo_Martínez_Corbalá
Nidia_Vílchez	successor	Paul_Jadin
Liisa_Jaakonsaari	party	Australian_Labor_Party
Sam_Olens	party	Social_Democratic_Party_of_Germany
Mark_B._Childress	predecessor	Otto_Baird_Price
Lorenzo_D._Harvey	party	Conservative_Party_(UK)
Rinus_Peijnenburg	country	Sweden
Ion_Balan	party	Labour_Party_(UK)
Mihail_Maculețchi	religion	Catholicism
John_E._Massey	successor	Bennett_Carr
Ng_Yen_Yen	successor	Nikki_Kaye
Albert_James_Smith_Copp	predecessor	Emad_Abdel_Ghaffour
Dan_Dockstader	party	Australian_Labor_Party
Derek_Mitchell	successor	Oliver_Miles
Croatian_Parliament	politicalPartyOfLeader	Labour_Party_(UK)
John_H._Couch	successor	George_Beetham
Rykers_Solomon	successor	Marc_Carrière
Horace_Walpole	successor	Alexander_Lewis
Robert_Genuario	successor	Patrick_Dankwa_Anin
John_Johnson_(Ohio_state_representative)	party	Social_Democratic_Party_of_Germany
Mool_Chand_Meena	party	Labour_Party_(UK)
John_Ceretto	otherParty	Fianna_Fáil
Sir_Richard_Browne,_1st_Baronet,_of_London	successor	Moses_Elijah_McGarry
Seema_Malhotra	party	Republican_Party_(United_States)
Juan_de_la_Cierva_y_Peñafiel	successor	Ron_Rosenfeld
Robert_Carr	predecessor	Brian_Ede
Alexandre_Duplessis	successor	Aleksandar_Nallini
Scott_Emerson	party	Civic_Platform
Tim_Harris_(politician)	party	Fianna_Fáil
Akpan_Isemin	successor	Charles_Nolin
Mary_Ann_O'Brien	party	Fianna_Fáil
Georgie_Crozier	party	Social_Democratic_Party_of_Germany
Tasker_Cook	successor	William_Barton_Northrup
Vincent_Goes_Ahead	successor	John_Alexander_Sullivan
Sam_McCann	party	Democratic_Party_(United_States)
Rhode_Island	predecessor	Tayseer_Qala_Awwad
Chen_Genkai	country	Serbia
Xu_Qiliang	party	Labour_Party_(UK)
Karl_Bitar	party	Progressive_Conservative_Party_of_Ontario
Massoud_Khalili	successor	Gustavo_Parraguez
Ismail_Hoxha	party	Social_Democratic_Party_of_Austria
Allison_Dysart	religion	United_Church_of_Canada
Ricca_Slone	party	Social_Democratic_Party_of_Germany
Alecia_Webb-Edgington	party	Labour_Party_(UK)
Lilia_Bolocan	party	Pakistan_Muslim_League_(N)
Revolutionary_Socialist_Workers'_Party_(Turkey)	internationalAffiliation	Kurdish_Brotherhood
William_Wilberforce	successor	Pierre_P._Garven_(mayor)
Stephen_Wall	predecessor	Vicente_T._Blaz
Christopher_Columbus_Nash	party	Fine_Gael
Gregory_B._Starr	successor	Sir_Humphrey_Forster,_2nd_Baronet
Vakkom_Purushothaman	party	Republican_Party_(United_States)
Matt_Jones_(politician)	party	Conservative_Party_(UK)
Frederick_Hoblitzell	party	Civic_Platform
Chris_Pappas_(politician)	party	Liberal_Party_of_Canada
Tun_Fuad_Stephens	successor	Ismail_Daut
John_Mildren	successor	Robert_C._Williams
Bryce_Mackasey	predecessor	Jean-Jacques_Martel
Robert_Charles_Winthrop	predecessor	István_Tisza
William_Ewart_Gladstone	party	National_Party_for_Development_and_Welfare
Howard_Clark_Hollister	party	Law_and_Justice
Jimmie_Massie	party	Australian_Labor_Party
Matteo_Renzi	party	Nazi_Party
Charles_C._Crabbe	party	Communist_Party_of_China
Matthew_S._Collier	country	Australia
George_Smathers	predecessor	George_Gekas
Brunó_Ferenc_Straub	successor	Daniel_Paillé
Theresa_El-Amin	country	Italy
William_Tyson_Wilson	country	Italy
Joy_Picus	party	Fianna_Fáil
Jack_Christian	party	Social_Democratic_Party_of_Austria
William_G._Stinson	party	Law_and_Justice
Henk_Vonhoff	successor	Otto_Baird_Price
Tom_Shannon	party	Conservative_Party_(UK)
Samuel_David_Mendelssohn	successor	Tim_Hill_(politician)
Femke_Halsema	successor	Arthur_C._Wheeler
David_Gourd	successor	Christopher_Warner
Hilbrand_Nawijn	party	Article_50
Rassemblement_Démocratique_Africain	country	United_Arab_Emirates
Carlos_Rodríguez_Mateo	successor	Ralph_Knox
Marcus_Aemilius_Lepidus_(consul_187_BC)	successor	Surat_Huseynov
Jean-Paul_Racine	party	Law_and_Justice
Neil_Erland_Byers	party	Law_and_Justice
Green_Algeria_Alliance	colour	Purple
Tiki_Lafe	successor	Richard_Vryling_Lesueur
Earl_Renneke	party	Democratic_Party_(United_States)
Gérard_Cournoyer	successor	Hastings—Frontenac
Guildford_Onslow	party	Law_and_Justice
Dóra_Dúró	party	Social_Democratic_Party_of_Germany
Edward_Avery_(judge)	party	Liberal_Party_(UK)
Edward_J._Kelley	party	Minnesota_Democratic–Farmer–Labor_Party
James_William_Freshfield	successor	James_Stuart_(scientist)
Nik_Abdul_Aziz_Nik_Mat	successor	Peter_Barry_(mayor)
Vijitha_Herath	religion	Presbyterianism
People's_Party_of_South_Ossetia	country	United_States
Segni_Pact	nationalAffiliation	The_Other_Europe
James_Buckham_Kennedy	predecessor	Jenny_Lindell
Joseph-Guillaume_Bossé	party	Progressive_Conservative_Party_of_Ontario
José_Irigoyen	successor	Rosemary_Spencer
Lancelot_Spurr	successor	Marc_Carrière
John_Blane	country	India
Sergio_Berlato	party	National_Alliance_(Latvia)
Hermann_Dietrich	country	Netherlands
John_Cosgrove_(Virginia_politician)	party	Conservative_Party_(UK)
Ron_Erickson	party	Liberal_Party_of_Canada
John_Lymburn	successor	Emilio_Portes_Gil
Sergio_Díaz-Granados_Guida	party	Indian_National_Congress
Nicolae_Dabija_(politician)	religion	Christian
Carol_Hanson	successor	Andrés_Mellado_Fernández
Carlo_Giovanardi	party	National_Harmony_Party
Concordancia_(Argentina)	country	Norway
Alejandro_Gómez_Maganda	party	Republican_Party_(United_States)
Camillo_Benso,_Count_of_Cavour	party	People's_Movement_of_Ukraine
James_L._Straight	successor	William_D._Gibbs
Luis_Ortíz_Lugo	party	Labour_Party_(UK)
Roy_C._Start	successor	Lisa_A._Gladden
Christof_Leng	country	Norway
Toni_Brunner	party	Pakistan_Muslim_League_(N)
Keith_Milligan	successor	Lloyd_MacPhail
János_Kóka	party	Democratic-Republican_Party
Beau_McCoy	party	Australian_Labor_Party
James_T._Austin	successor	Fred_R._Pierce
Agrarian_Party_of_Moldova	country	India
Imre_Pesti	party	Austrian_People's_Party
Claude_Hall	party	Indian_National_Congress
Joshua_Westhead	country	France
A._J._M._Muzammil	party	Sinn_Féin
A._George_Pradel	party	Communist_Party_of_China
Jacob_Weager	successor	John_Macdonell
Manó_Széchényi	successor	Bennett_Carr
André_Bachand_(Progressive_Conservative_MP)	successor	John_Horgan_(Canadian_politician)
Gitanjana_Gunawardena	religion	Judaism
Kinza_Clodumar__Kinza_Clodumar__1	successor	Doug_Mowat
Barrett_Rich	party	Fianna_Fáil
Robb_Kahl	party	Social_Democratic_Party_of_Germany
Sergio_Berlato	party	Communist_Party_of_Spain
Richard_Taylor_(Canadian_politician)	successor	George_A._Burridge
Hansjörg_Schmidt	party	Indian_National_Congress
Genaro_Borrego_Estrada	successor	Nicolas_Chambon
Donald_R._Norland	country	Sweden
Croatian_Parliament	politicalPartyInLegislature	A_Just_Russia
Pat_Kronebusch	party	Liberal_Party_of_Canada
Lyudmyla_Denisova	otherParty	Austrian_People's_Party
Arjan_El_Fassed	party	Progressive_Conservative_Party_of_Ontario
Mark_Robinson_(Australian_politician)	predecessor	John_Fusco_(politician)
Alfonso_López_Michelsen	successor	Laureano_Gómez
Ambrose_Burnside	battle	Balochistan_conflict
United_Democratic_Forum_Party	country	Hungary
Francesco_Cossiga	party	VIZE_2014
Bernard_Piras	party	Law_and_Justice
Tiberius_Claudius_Pompeianus	successor	John_Coates_(Australian_politician)
Angela_Corey	religion	Islam
Enkelejd_Alibeaj	party	Australian_Labor_Party
Neil_Bell_(Australian_politician)	party	Republican_Party_(United_States)
Maxwell_M._Hamilton	successor	Peter_Douglas_McLean
Wu_Chaoshu	successor	John_Archibald_McDonald_(Saskatchewan_politician)
Félix_Berenguer_de_Marquina	successor	Abu_Bakar_Mohamad_Diah
Huang_Boyun	party	Australian_Labor_Party
New_Right_(Netherlands)	colour	Purple
John_Paul,_Jr._(judge)	successor	Waltraud_Rheinhardt
Donetta_Davidson	party	Independent_politician
John_G._Breslin	party	Minnesota_Democratic–Farmer–Labor_Party
Second_Presidency_of_Alan_García	party	Austrian_People's_Party
Dene_Smuts	party	Liberal_Party_(UK)
Pacifist_Socialist_Party	leader	Gerry_Healy
D._E._W._Gunasekera	party	Liberal_Party_(UK)
Eleanor_Norrie	successor	Christopher_Warner
Die_Friesen	country	Serbia
Alphée_Poirier_(MP)	successor	James_Masson
Kevin_McKeever	party	Fianna_Fáil
Lucius_Seth_Huntington	successor	Greg_Fergus
Roel_van_Duijn	party	The_National_Alliance
Carlos_Bianchi_Angleró	party	Labour_Party_(UK)
Pierre_Laurent_(politician)	party	Conservative_Party_(UK)
John_James_McShane	party	Liberal_Party_(UK)
Guillermo_Linares	party	Liberal_Party_(UK)
John_Handley_(MP)	party	Indian_National_Congress
Cristian_Moreno_Panezo	successor	Lyle_Stewart
William_A._Schnader	predecessor	Jared_Benson
Gábor_Világosi	party	Democratic_Party_(United_States)
Gleisi_Hoffmann	predecessor	John_Stevenson_(Queensland_politician)
Magnus_Cormack	successor	José_Olaguer_Feliú
Sarath_Ranawaka	religion	Jews
V._V._Whittington	party	Fine_Gael
Wesley_Meredith	party	Civic_Platform
Ron_James_(politician)	party	Liberal_Party_of_Canada
Pavlo_Tychyna	successor	William_King_(Governor_of_West_Florida)
Lénárd_Borbély	party	Conservative_Party_(UK)
Antonio_López_de_Santa_Anna	party	Liberal_Party_of_Australia
Ghad_El-Thawra_Party	country	Israel
Adrien_Meunier	party	Democratic_Party_(United_States)
Enrique_Mac_Iver	party	Democratic_Party_(United_States)
Nicholas_Fuller_(lawyer)	successor	Jules-Joseph-Taschereau_Frémont
Alexander_McFarland	successor	Joe_Gander
Dulce_María_Sauri_Riancho	successor	David_Harris_(Australian_politician)
Massoud_Khalili	successor	Edward_T._Humphries
Jessie_Cortés_Ramos	party	New_Democratic_Party
Henri_Falcón	party	Liberal_Party_(UK)
Roel_van_Duijn	party	Panameñista_Party
Richard_Morthland	party	Pakistan_Muslim_League_(N)
United_Front_of_Principlists	nationalAffiliation	Pakatan_Rakyat
Walter_Ulbricht	party	Trust_(British_political_party)
Jack_Chamberlain_(politician)	successor	Gilbert_Heathcote-Drummond-Willoughby,_1st_Earl_of_Ancaster
Toni_Brunner	party	Austrian_People's_Party
Charles_de_Gaulle	party	Lebanese_Democratic_Party
Nayon_Bilijo	party	Liberal_Party_of_Canada
Jack_Keir	successor	Geoffrey_Eagar
LNNK	colour	Pink
Ferenc_Duschek	successor	George_W._Vaughn
Socialist_Equality_Party_(Sri_Lanka)	internationalAffiliation	Interlibertarians
Grier_Raggio	party	Communist_Party_of_China
Gjergji_Papa	party	Indian_National_Congress
Jack_Yost	party	Australian_Labor_Party
Frank_Pierrepont_Graves	party	Labour_Party_(UK)
Māris_Riekstiņš	party	Democratic_Party_(United_States)
W._M._Salisbury	successor	Dariush_Mostafavi
Thierry_Repentin	party	Social_Democratic_Party_of_Austria
Bertrand_Pancher	party	Law_and_Justice
Walter_Brugmann	party	Liberal_Party_(UK)
John_M._Sheets	party	Liberal_Party_of_Canada
Marcus_Aemilius_Lepidus_(consul_187_BC)	successor	Petr_Šimerka
Glen_Milliner__Australia-Labor-politician-stub__1	party	Fianna_Fáil
Gyula_Kornis	successor	Joseph_McIntyre
Zhou_Tienong	party	New_Zealand_Labour_Party
Michael_D._Protack	party	Communist_Party_of_China
Somsanith_Vongkotrattana	party	Fianna_Fáil
Armand_Jung	party	Fianna_Fáil
Marco_Biagi_(politician)	party	Fianna_Fáil
Russ_Gorman	successor	Andrés_Mellado_Fernández
Art_Donahoe	successor	Don_Mazankowski
John_Hunt_(Australian_politician)	religion	Hindu
Willem_Johannes_Leyds	successor	Katarina_Kämpe
Tim_Harris_(politician)	successor	Colin_Gabelmann
Doug_Stoner	party	Austrian_People's_Party
José_Manuel_Ramos_Barroso	party	Republican_Party_(United_States)
Geoffrey_Edmund_Cator	successor	László_Toller
Marcus_Aemilius_Lepidus_(consul_187_BC)	successor	William_Long_(Northern_Ireland_politician)
Joshua_Milne_Cheetham	country	Germany
Massimo_D'Alema	predecessor	Henry_Addington,_1st_Viscount_Sidmouth
K._Kamaraj	predecessor	Ponnambalam_Ramanathan
Edmundo_Pérez_Yoma	party	Law_and_Justice
Petr_Kolář	country	China
Marwan_Habash	party	Labour_Party_(UK)
Hossein_Namazi	predecessor	Henry_Addington,_1st_Viscount_Sidmouth
Callum_McCaig	party	Social_Democratic_Party_of_Germany
Marcus_Aemilius_Lepidus_(consul_187_BC)	successor	Charles_Holder
Alliance_for_Change_(Macau)	nationalAffiliation	March_14_Alliance
Victor_Veysey	successor	William_Cogswell
Clark_Bissell	predecessor	Cletus_Avoka
Fouad_Douiri	party	Law_and_Justice
Eli_Nesdoly	successor	Howard_Corning
Rahui_Katene	successor	Edvard_Beneš
Viktor_Viktorovych_Yanukovych	party	Sinn_Féin
Cecile_B._Kremer	successor	Wilbraham_Tollemache
Ernst_Rüdiger_Starhemberg	party	Austrian_People's_Party
Memucan_Hunt,_Jr.	successor	Han_Changfu
John_L._Jolley	successor	Oloff_Johannes_Truter
Richard_Funkhouser	successor	Richard_Funkhouser
National_Movement_(Poland)	country	Ghana
Yasmín_Mejías	party	Fianna_Fáil
Mariastella_Gelmini	party	Socialist_Party_(France)
Miklós_Bonczos	predecessor	Raymond_Préfontaine
Mike_McLarnon	successor	Randolph_McKinnon
Mitchell_Hepburn	predecessor	John_Fabyan_Parrott
Giles_Radice,_Baron_Radice	soundRecording	Julian_Huppert__7
Femke_Halsema	successor	Ahmed_Elmi_Osman
William_Gould_Newman	party	Fianna_Fáil
Chamber_of_Deputies_(Mexico)	politicalPartyInLegislature	German_Minority_Electoral_Committee
Marguerite_Lamour	party	Democratic_Party_(United_States)
Massoud_Khalili	successor	David_Vaughan_Pugh
Shevrin_D._Jones	party	Conservative_Party_(UK)
Royal_Theodore_Graham	successor	Isabelle_Diks
Henry_Fenwick	country	Netherlands
S._Otis_Bland	successor	Lucien_Boudreau
Edward_Gibbon	successor	Jason_Hale_(politician)
Barry_MacKinnon	successor	Gilbert_Heathcote-Drummond-Willoughby,_1st_Earl_of_Ancaster
Arthur_Townsend	religion	Hindu
Louis_Buffet	successor	Gösta_Bohman
Bernard_Corser	party	Austrian_People's_Party
John_Mann_(Australian_politician)	otherParty	Law_and_Justice
William_Abraham_(trade_unionist)	party	Independent_politician
Frank_P._Bennett,_Jr.	party	Australian_Labor_Party
Frank_Maine	party	Social_Democratic_Party_of_Austria
Winnie_Byanyima	spouse	Mariana_del_Alcázar
Henry_Marchant	successor	Wilbraham_Tollemache
Liechtenstein	leader	Nii_Quaynor
William_Mackenzie_Davidson	party	Conservative_Party_(UK)
Petra_Kammerevert	party	Fine_Gael
Hilbrand_Nawijn	party	Labour_Party_(South_Africa)
Arthur_Townsend	successor	Bawa_Andani_Yakubu
Gervasio_Cruzat_y_Góngora	successor	Andrés_Mellado_Fernández
Octavian_Țîcu	successor	Donald_Sinclair_(diplomat)
Pan_American_Health_Organization	leader	Veronika_Skvortsova
Rüdiger_Butte	country	Turkey
Costas_Papacostas	party	Social_Democratic_Party_of_Austria
Henry_Forster,_1st_Baron_Forster	successor	Veerasamy_Ringadoo
Jacques_Myard__France-politician-UMP-stub__1	party	Conservative_Party_(UK)
Radu_Vasile	otherParty	Union_for_French_Democracy
Teima_Onorio	party	Communist_Party_of_China
Alejandro_Rodríguez_de_Valcárcel	successor	Desmond_Code
Vincent_Perera	successor	Tarek_Saab
George_Haudenshield	party	Indian_National_Congress
Andrew_Bartlett	party	Dialogue_for_Hungary
Ruben_Zackhras	successor	Curtis_Pitt
Massoud_Khalili	successor	Georgios_Georgiadis_(Prince_of_Samos)
Helmut_Angula	party	Conservative_Party_(UK)
Greg_Brower	party	Conservative_Party_(UK)
Stanley_W._Holmquist	party	National_Party_of_Australia
Garland_E._Pierce	party	Australian_Labor_Party
Sam_Rasoul	party	Austrian_People's_Party
Michael_Gamble	party	Social_Democratic_Party_of_Austria
Gary_Black_(agriculture_commissioner)	religion	Christian
Frenti-Mudança	country	Italy
Marcus_Aemilius_Lepidus_(consul_187_BC)	successor	Bernadette_Allen
Theophilus_Albert_Willy	party	Labour_Party_(UK)
Manfred_Ostermann	country	Australia
Kamel_Morjane	successor	Charles_Henderson_(Canadian_politician)
Evan_Moorhead	party	Indian_National_Congress
Raymond_Laborde	party	Labour_Party_(UK)
Iurie_Muntean	party	Sinn_Féin
Wang_Jun_(politician)	party	Law_and_Justice
K._Marappa_Gounder	party	Communist_Party_of_China
Gunaratna_Weerakoon	country	United_Kingdom
Malek_Mansur_Mirza_Shoa_O-Saltaneh	party	Independent_politician
Illinois	predecessor	Ernst_Höfner
Quinto_Martini	successor	Mike_Davison
William_Rodger_Shane	party	Liberal_Party_(UK)
Peter_C._Bacon	party	Indian_National_Congress
John_Faulkner	predecessor	Brad_Hazzard
Brian_Nieves	party	Austrian_People's_Party
Lucy_Flores	party	Conservative_Party_(UK)
Jatuporn_Prompan	party	People's_National_Convention_(Ghana)
Curt_Thompson	party	Republican_Party_(United_States)
Miroslava_Němcová	predecessor	Otto_Baird_Price
Sir_Richard_Browne,_1st_Baronet,_of_London	successor	Valeriy_Kuchynsky
Chillion_L._Miller	religion	Baptists
R._Kuhaneswaran	party	Communist_Party_of_China
Chaudhry_Muhammed_Farooq	religion	Islam
Thomas_Helbling	party	Australian_Labor_Party
Iñigo_Urkullu	party	Communist_Party_of_China
Víctor_Manuel_Ortíz	successor	Steve_Thomson_(politician)
Juan_de_la_Cierva_y_Peñafiel	successor	John_Drysdale
Gabriel_Ste-Marie	successor	Gabriel_Ste-Marie
Juan_de_la_Cierva_y_Peñafiel	successor	Edgar_Russell
Paul_Merriman	party	Australian_Labor_Party
Herbert_Mayr	party	Conservative_Party_(UK)
Athula_Wijesinghe	party	Australian_Labor_Party
Michel_Destot	successor	Norman_MacMillan_(politician)
Pedro_A._Rodríguez	party	Communist_Party_of_China
Zoe_Bettison	party	Labour_Party_(UK)
Dan_Mulcahy	party	Communist_Party_of_China
D._S._Senanayake	successor	Snyder_Rini
Steve_Wettenhall	party	New_Democratic_Party
Femke_Halsema	successor	Suresh_Kalmadi
Jean_Marc_Chaput	party	Communist_Party_of_China
Douglas_Horne	party	Social_Democratic_Party_of_Austria
Walter_Ulbricht	party	Fearless_People's_Alliance
John_Francis_Buckland	predecessor	J.-Eugène_Lefrançois
Jacquie_Petrusma	party	Social_Democratic_Party_of_Germany
United_Front_of_Principlists	country	Israel
Ty_Masterson	party	Labour_Party_(UK)
Rosy_Bindi	party	Freedom_Party_in_Carinthia
Mark_J._F._Schroeder	predecessor	Rufus_S._Frost
Marcus_Aemilius_Lepidus_(consul_187_BC)	successor	George_Fulford
Joe_Anderson_(politician)	party	Austrian_People's_Party
William_Arthur_(Australian_politician)	successor	Jan_Jacob_Rochussen
Bert_Wollants	party	Conservative_Party_(UK)
Moses_Adasu	successor	Fernando_Ortiz_Arana
Nasuhi_al-Bukhari	predecessor	Raymond_Loewen
Paul_Painlevé	successor	Paul_Painlevé
Wilbert_Ross_Aylesworth	successor	A._H._Moore
Lyle_Koenen	party	Social_Democratic_Party_of_Austria
Miriam_Ramírez	party	Conservative_Party_(UK)
Walter_Ulbricht	party	Accord_(Nigeria)
John_Hodges_(Australian_politician)	successor	Jim_Rodgers_(politician)
George_Nicholson_(politician)	party	Austrian_People's_Party
Ion_Ustian	party	Conservative_Party_(UK)
Miloslav_Vlček	successor	Ad_Hermes
A._Chandrasekaran	party	Fianna_Fáil
Nelson_S._Smith	successor	Nelson_S._Smith
Călin_Vieru	religion	Catholicism
Jonathan_Bell_(UK_politician)	predecessor	Carmen_Lawrence
William_M._Walton	party	Conservative_Party_(UK)
Arlene_Singer	party	Indian_National_Congress
Chuck_Puchmayr	successor	Sterling_Belliveau
Robert_C._Buell	party	Austrian_People's_Party
Yusuf_Hassan_Abdi	party	Austrian_People's_Party
Ed_Renwick	party	Fianna_Fáil
Richmond_Hursthouse	successor	Geoffrey_George_Knox
Terrie_Wood	party	Liberal_Party_(UK)
Matt_Gabler	party	Conservative_Party_(UK)
Ottaviano_Del_Turco	party	Alliance_of_Free_Democrats
Joe_Sam_Queen	predecessor	Abdullahi_Sarki_Mukhtar
Marcus_Aemilius_Lepidus_(consul_187_BC)	successor	Carl_Michael_Smith
Cal_Ludeman	party	Republican_Party_(United_States)
Anouchka_van_Miltenburg	party	Social_Democratic_Party_of_Germany
Tim_Donnelly_(politician)	party	Liberal_Party_of_Canada
Hilbrand_Nawijn	party	Democratic_Party_(Hong_Kong)
Lerryn_Mutton	successor	Francis_Shepherd
Matthew_Mirones	party	Independent_politician
John_Abel_(politician)	party	Australian_Labor_Party
Hubert_Seamans	successor	Colin_Gabelmann
Mike_Dow	religion	Islam
Fernando_Álvarez_de_Toledo,_3rd_Duke_of_Alba	successor	Edward_Fearon
Gary_George_(Wisconsin_politician)	party	Conservative_Party_(UK)
Sy_Schulman	religion	Hindu
Joseph_Nicholas_Bell	country	Germany
Paul_Davis_(Maine_politician)	party	Civic_Platform
John_Watts_(Grenadian_politician)	party	Socialist_Party_of_Albania
Alasdair_Webster	successor	John_Barilaro
Kamil_Jankovský	predecessor	Vincent_Badie
E._M._V._Naganathan	party	Fianna_Fáil
Robert_Grant_(Kansas_politician)	party	Indian_National_Congress
Joseph_McAneny	party	Indian_National_Congress
Fletcher_Stewart_Thomas	country	Norway
Rhode_Island	predecessor	Habu_Daura
Phil_Baddour	party	Law_and_Justice
György_Czerván	party	Indian_National_Congress
Nikolai_Janson	party	Fine_Gael
Franck_Riester	party	Liberal_Party_(UK)
Marc_Lalonde	predecessor	Joe_Volpe
Nguyễn_Thị_Doan	party	Communist_Party_of_China
Raymond-Max_Aubert	party	Social_Democratic_Party_of_Germany
Tom_Copley	party	Civic_Platform
Andrew_Querbes	religion	Hinduism
Peter_F._Schabarum	party	Fianna_Fáil
Daniel_Alexander_Cameron	predecessor	Edward_Corser
Valeriu_Lazăr	religion	Jews
Casey_O._Anderson	party	Conservative_Party_(UK)
Robert_Hagopian	party	Law_and_Justice
Henri_Cuq	party	Minnesota_Democratic–Farmer–Labor_Party
Henry_Frank_Jones	successor	Aleksandar_Nallini
Frederick_Llewellyn-Jones	successor	Andrés_Mellado_Fernández
Luis_Alva_Castro	successor	Anthony_Onyearugbulem
Inga_Bite	party	Conservative_Party_(UK)
Martín_de_Alarcón	successor	Rodger_Randle
Paul_von_Buri	successor	Frank_Christian_(politician)
Anne-Marie_Comparini	successor	Girish_Chandra_Saxena
Lazo_M._Kostić	party	Social_Democratic_Party_of_Austria
Wilhelm_Rudolf_Mann	party	Minnesota_Democratic–Farmer–Labor_Party
Richard_S._Williamson	party	Austrian_People's_Party
Scott_Dietterick	party	Austrian_People's_Party
Earl_Williams_(politician)	successor	José_Reyes_Baeza_Terrazas
V._Susan_Sosnowski	party	Australian_Labor_Party
Václav_Jehlička	party	Fine_Gael
Riojan_parliamentary_election,_1983	secondLeader	Ramón_Guillermo_Aveledo
Blake_Pedersen	party	Republican_Party_(United_States)
Hubert_Minnis	party	Liberal_Party_(UK)
José_Tormos_Diego	successor	José_Gregorio_Salazar
Tony_Ehrenreich	party	Fianna_Fáil
Antal_Günther	successor	Gilbert_Heathcote-Drummond-Willoughby,_1st_Earl_of_Ancaster
Ottaviano_Del_Turco	party	Kenseikai
Boyd_R._Overhulse	successor	Steve_Russell_(politician)
Lin_Fong-cheng	party	Democratic_Party_(United_States)
Jorge_Luis_Garcia	party	Pakistan_Muslim_League_(N)
Derog_Gioura__Derog_Gioura__1	successor	Tarek_El_Aissami
Alphonse_J._Jackson	party	Social_Democratic_Party_of_Austria
Miklós_Hasznos	party	Chama_Cha_Mapinduzi
Prince_Casinader	party	Austrian_People's_Party
Bill_Harmer	successor	Ibrahim_Alkali
George_Prime	party	Austrian_People's_Party
Damase_Bouvier	successor	James_Bowman_(Canadian_politician)
Gordon_Denlinger	party	Austrian_People's_Party
Paul-Henri_Meyers	party	Communist_Party_of_China
Larry_Howes	party	Communist_Party_of_China
Juan_de_la_Cierva_y_Peñafiel	successor	Saleh_al-Rashed
George_Gascón	party	Austrian_People's_Party
Sid_French	party	Pakistan_Muslim_League_(N)
Attila_Gruber	party	Social_Democratic_Party_of_Austria
Arturo_Chávez_Chávez	party	Civic_Platform
Ohn_Maung	party	Minnesota_Democratic–Farmer–Labor_Party
Andy_Anders	party	Social_Democratic_Party_of_Germany
John_W._Hickman	party	Civic_Platform
Authenticity_Party	nationalAffiliation	National_Democracy_Movement_(Philippines)
Stephanie_Miner	party	Austrian_People's_Party
Edmund_Boyd_Osler_(Manitoba_politician)	successor	Francisco_Cuervo_y_Valdés
Communist_Party_of_the_Philippines	nationalAffiliation	United_Left_Alliance
Youssef_Zulficar_Pasha	religion	Presbyterianism
M._Alalasundaram	party	Communist_Party_of_China
Hannelore_Kraft	predecessor	James_Jackson_(Georgia_politician)
Tom_Driberg	successor	Nils_Torvalds
Mousa_Namjoo	successor	Jules-Joseph-Taschereau_Frémont
Marcel_Deschambault	successor	J.-Eugène_Lefrançois
Ambrose_Burnside	battle	Syria–Lebanon_Campaign
Ken_Lackey	party	Democratic_Party_(United_States)
John_C._Elliott	successor	Colin_Gabelmann
Louis_Lausier	party	Indian_National_Congress
Abdul'aziz_Abubakar_Yari	party	New_Democratic_Party
Fares_al-Khoury	predecessor	Aeneas_Mackay
Gajendrakumar_Ponnambalam	party	Law_and_Justice
Massoud_Khalili	successor	William_R._Rivkin
Amir_Kabir	successor	Brewster_Morris
Salleh_Kalbi	religion	Hindu
Khmer_Renovation	nationalAffiliation	Barisan_Nasional
Roger_Johnston	party	Australian_Labor_Party
Kelton_B._Miller	party	Law_and_Justice
Kingsley_Sit	party	Democratic_Party_(United_States)
Valeriy_Borzov	party	New_Forum_for_the_Restoration_of_Democracy–Kenya
Hector_Dupuis	party	Independent_politician
Paul_C._McKain	religion	Episcopal_Church_(United_States)
Ruth_Kagi	party	Australian_Labor_Party
Jarvis_Johnson	party	Fianna_Fáil
Charles_Kurfess	party	Fine_Gael
David_Hahn_(Canadian_politician)	party	Australian_Labor_Party
Barryl_Biekman	country	France
Liss_Schanche	party	Democratic_Party_(United_States)
Alpheus_B._Alger	party	Liberal_Party_(UK)
James_F._Moriarty	successor	Fort_St._David
Harold_W._Clemens	country	Germany
William_C._Clendinneng	party	Indian_National_Congress
Alfred_Ngaro	party	Liberal_Party_(UK)
Gheorghe_Papuc	successor	Catherine_A._Novelli
Chen_Fu-hai	predecessor	Helmuth_von_Maltzahn
Joey_Smallwood	successor	Federico_Franco
Sergio_Berlato	party	Women's_Equality_Party
István_Ujhelyi	party	Independent_politician
